████████████████████████████████████████████████████████████████████████████████████████████████████
█                █                                                      █                          █
█                █                                                      █                          █
█                █                                                      █                          █
█                █                                                      █                          █
█                █                                                      █                          █
█                █                                                      █                          █
█                █                                                      █                          █
█                █                                                      █                          █
█                █                                                                                 █
█                █                                                                                 █
█                                                              █████████████████████████████████████
█                                                                                                  █
█                                                                                                  █
█                                                                                                  █
█                                     █                                                            █
█                                     █                                                            █
█                                     █                                                            █
█                                     █                                                            █
█                                     █                          ████████                          █
█                                     █                          ████████                          █
█                                     █                          ████████                          █
█                                     █                                                            █
█                                     █                                                            █
█                                     █                                                            █
█                                     █                                                            █
█                                     █                                                            █
█                                     █                                                            █
█                                     █                                                            █
████████████████████████████████████████████████████████████████████████████████████████████████████